20 20
18 0
6 19
11111111111111111111
10001111100000000111
11101111110111110111
11100000000000110111
11101111110111110111
11101111110111110111
11101100000000110000
11101101110111111111
11101101110110000111
11101101111111110111
11101101111111110111
10001101100000000111
11101111110110110111
11100000000000110111
11101111110111110111
11101111110111110111
11101100000000110001
11101111110111110111
00001111110110000111
11111111111111111111